
EA ./assets/textures/ea_texture.png
NO ./assets/textures/purplestone.png
SO ./assets/textures/wall_1.png
WE ./assets/textures/so_texture.png

F 70,70,70
C 150,30,225


1

      111111 111111111
     1100001 100000001
    11001001 100000001
   110011001 111111001
  1100111001     11001
 11000000001 111111001
 11111111001 100000001
 11111111001 100111111
       11001 10011
       110011100111111
       1100111000000W1
       110000000000001
       111111111111111