
EA ./assets/textures/ea_texture.png
NO ./assets/textures/purplestone.png
SO ./assets/textures/wall_1.png
WE ./assets/textures/so_texture.png

F 220,100,0
C 150,30,225


1

      111111  11111111
     1100001  10000001
    11001001  10000001
   110011001  11111101
  1100111001       101
  1000000001  11111101
  1111111001  10000001
       11001  10111111
       11001  101
       110011110111111
       1100000000000W1
       110000000000001
       111111111111111