
EA ./assets/textures/ea_test.img
NO ./assets/textures/no_test.img
SO ./assets/textures/so_test.img
WE ./assets/textures/we_test.img

F 220,100,0
C 150,30,225


        1111111111111111111111111
        1000000000110000000000001
        1011000001110000000000001
        1001000000000000000000001
111111111011000001110000000000001
11110000000001100000033222222222222
   101110001111111100300000000000E1
11110111001111011100030000001111111
11000000000000000100000010001
10000000000100000100000010001
10000000000100000101010010001
11000001111100011111011110001
11110111 1110001 101111010001
11111111 1111111 111111111211
