
EA ./assets/textures/ea_texture.png
NO ./assets/textures/purplestone.png
SO ./assets/textures/wall_1.png
WE ./assets/textures/so_texture.png

F 220,100,0
C 150,30,225



   111111     11111111
  1100001     10000001
 11001001     11111101
110011101          101
100000001     11111101
111111001     10000001
     10011    10000001
     100N1    11111101
     11111
