
EA ./assets/textures/ea_texture.png
NO ./assets/textures/purplestone.png
SO ./assets/textures/wall_1.png
WE ./assets/textures/so_texture.png

F 220,100,0
C 150,30,225


111111111111111111111111111
100000000000000000000000001
101111011111011111011110101
101000010000010000010010101
101011110111010111011010101
100010000000010000000010001
111010111111011111010111111
100010000000000000010000001
101111111111111111111110101
100000000000000000000000001
101111011111011111011111101
101000010000010000010000101
101011110111010111011110101
100010000010010000000010001
111010110010011111010110111
100010010010000000010010001
101111110111011111111111101
10000000N000000000000000001
111111111111111111111111111

