
EA ./assets/textures/ea_texture.png
NO ./assets/textures/purplestone.png
SO ./assets/textures/wall_1.png
WE ./assets/textures/so_texture.png

F 220,100,0
C 150,30,225


1111111111111111111
1000000000000000001
1011110111110111101
1010000000000000101
1010111111011110101
1000100000000010001
1110101111110101111
1000100000000010001
1011111111011111101
1000000E00000000001
1111111111111111111
