EA ./assets/textures/ea_texture.png
NO ./assets/textures/no_texture.png
SO ./assets/textures/so_texture.png
WE 

F 220,100,0
C 225,30,0


        1111111111111111111111111
        1000000000110000000000001
        1011000001110000000000001
        1001000000000000000000001
111111111011000001110000000000001
11110000000001100000111011111111111
   11111110111111111011100000010001
11110111111111011101010010001111111
11000000110101011100000010001
10000000000000001100000010001
10000000000000001101010010001
11000001110101011111011110001
11110111 1110101 101111010001
11111111 1111111 111111111111